1111111111111
1E110CP000001
1010011111001
1000110000C01
1111111111111