1111111111111111111111111111111111
100000P00000000000000C00000I000001
100001C010101010001001000000010101
1010010010101000101001000000010101
101001001010101000100100000E010101
1010010010101010001001000000010101
1010010010101010001001000000010101
1010010001101001001001000000010101
1010010001101001001001000000010101
1010010001101001001001000000010101
1010010001101001001001000000010101
10100100I1101001I01001000000010101
1010010001101001001001000000010101
1010010001101001001001000000010101
1010010001101001001001000000010101
1010010010101010001001000000010101
101001001010101000100100000C101001
10I0000000000C00000000000000C00001
1111111111111111111111111111111111